8
14
5 2 3 4 1 7 5 7 1 4 2 6 4 0
4 1 4 3 7 2 2 1 6 6 1 6 1 2
1 1 1 1 3 4 2 1 1 4 1 3 6 3
3 1 5 5 2 1 6 2 1 1 5 2 6 2
4 2 3 2 5 5 3 1 5 3 1 6 3 1
5 1 3 5 3 1 3 1 6 2 2 3 5 3
1 2 3 7 4 1 1 5 3 1 2 5 1 1
2 2 1 2 1 7 1 5 7 2 6 3 2 3