11
12
7 1 3 1 1 2 6 6 5 1 6 3
7 2 1 2 6 1 6 3 5 2 2 1
2 7 2 3 2 1 1 1 2 1 1 3
1 1 1 5 3 4 3 0 3 4 5 1
1 3 7 1 2 7 1 1 2 6 3 5
3 6 3 3 3 6 2 5 1 1 2 2
2 1 1 3 2 3 5 3 2 5 3 4
1 5 1 2 1 6 3 6 1 2 2 3
7 7 2 6 3 3 2 4 2 1 3 1
1 6 6 6 3 1 7 1 3 1 5 3
6 4 1 3 2 2 3 2 1 1 3 3