10
8
1 1 5 1 5 6 5 0
3 1 2 3 6 2 1 1
1 7 2 7 6 2 5 6
1 2 1 3 1 2 5 6
5 2 2 2 2 3 3 7
1 1 3 4 1 6 1 6
7 1 2 5 4 6 7 3
1 1 3 2 1 3 1 4
3 1 1 3 3 6 4 3
3 7 4 1 4 2 6 1