7
13
4 1 5 3 6 4 1 1 5 3 1 6 2
0 1 3 2 6 2 1 2 1 3 7 5 2
1 4 6 5 3 1 2 1 5 2 1 1 5
5 1 4 2 3 3 6 1 3 2 1 4 2
3 2 5 3 1 6 1 1 1 2 2 1 1
3 3 1 3 1 2 1 1 2 7 2 3 1
3 6 6 1 2 2 1 1 5 3 1 3 6