13
10
4 2 3 7 3 0 1 1 1 3
4 2 6 3 6 3 2 1 2 5
1 4 3 2 7 3 6 2 5 3
6 3 1 1 7 3 5 2 2 1
2 5 3 1 5 5 7 3 2 2
7 6 2 3 7 3 6 2 2 2
2 3 2 4 1 1 1 5 1 1
1 1 6 2 3 2 6 1 1 2
3 2 5 3 3 1 2 2 6 1
2 1 4 1 1 5 6 3 3 2
3 2 5 1 6 6 2 2 1 2
5 5 1 2 1 1 1 3 5 1
7 1 7 5 2 3 1 6 2 4