11
12
2 2 3 5 2 2 3 2 3 5 4 5
3 5 3 1 2 5 5 2 2 4 5 5
3 5 2 3 3 3 2 0 3 5 5 2
4 3 3 3 5 4 2 1 3 2 5 5
2 1 3 2 2 5 2 3 3 5 2 3
3 2 5 5 3 3 5 2 5 5 2 2
3 3 5 5 4 2 5 5 3 5 5 3
3 5 2 3 3 3 5 3 2 3 3 2
1 5 5 2 5 3 5 3 1 3 1 2
5 3 3 3 3 5 5 5 2 2 5 4
3 1 3 2 1 3 5 5 1 2 3 5