15
15
3 5 6 6 1 6 6 6 0 6 6 6 4 4 1
3 2 6 6 6 6 6 2 6 6 1 4 3 2 6
6 6 6 3 6 1 3 3 6 5 3 1 3 3 4
6 2 1 6 6 4 6 6 6 1 6 6 6 6 6
1 3 1 1 2 5 3 1 6 4 1 2 1 6 3
6 4 6 2 4 1 1 6 6 6 6 1 4 6 6
6 6 1 6 2 3 3 3 3 5 6 6 6 6 6
2 6 1 2 1 6 6 6 3 6 6 6 6 5 1
6 2 2 3 3 6 2 2 6 1 1 2 6 6 6
3 2 6 3 2 3 1 3 3 1 4 2 5 6 4
6 3 6 4 2 4 4 4 3 6 3 6 6 3 1
3 6 3 5 6 6 6 2 6 3 6 6 1 1 5
6 6 6 6 3 1 6 6 6 6 6 2 6 2 3
5 1 3 3 2 5 4 1 1 6 3 6 6 1 2
1 2 5 1 6 3 6 5 3 2 5 6 1 6 6