14
9
3 2 3 1 7 6 5 2 7
7 7 3 7 1 3 1 2 7
7 6 5 6 3 2 6 3 3
5 7 7 7 7 5 6 7 7
7 7 7 2 7 7 7 3 7
7 7 3 7 1 1 6 7 7
7 2 2 7 2 7 7 7 6
3 3 7 7 3 3 7 1 6
5 7 7 6 1 7 6 7 5
1 0 1 7 3 2 7 7 7
7 7 2 3 7 3 7 3 2
7 7 2 7 5 7 3 4 7
7 7 5 7 1 5 7 7 6
7 1 7 3 3 3 7 2 1